あう	あう	au	to meet
あく	あく	aku	open
あける	あける	akeru	to open
あげる	あげる	ageru	to give
あそぶ	あそぶ	asobu	to play
あびる	あびる	abiru	to take a shower
あらう	あらう	arau	to wash
ある	ある	aru	to possess
あるく	あるく	aruku	to walk
いう	いう	iu	to say, to tell
いく	いく	iku	to go
いる	いる	iru	to exist
いれる	いれる	ireru	to insert, to put in
うたう	うたう	utau	to sing
うまれる	うまれる	umareru	to be born
うる	うる	uru	to sell
おきる	おきる	okiru	to get up, to stand up
おく	おく	oku	to put
おくる	おくる	okuru	to send
おす	おす	osu	to push
おぼえる	おぼえる	oboeru	to memorize, to remember
およぐ	およぐ	oyogu	to swim
おりる	おりる	oriru	to get off
おわる	おわる	owaru	to end
かう	かう	kau	to buy
かえす	かえす	kaesu	to return an object
かえる	かえる	kaeru	to return home
かかる	かかる	kakaru	to take time or money
かく	かく	kaku	to write
かける	かける	kakeru	to wear
かす	かす	kasu	to lend
かぶる	かぶる	kaburu	to put on a hat
かりる	かりる	kariru	to borrow
きえる	きえる	kieru	to go out, to vanish
きく	きく	kiku	to listen
きる	きる	kiru	to cut
くる	くる	kuru	to come
けす	けす	kesu	to turn off, to switch off
こたえる	こたえる	kotaeru	to answer
こまる	こまる	komaru	to be in trouble
さく	さく	saku	to blossom
さす	さす	sasu	to open an umbrella
しぬ	しぬ	shinu	to die, to pass away
しまる	しまる	shimaru	to close
しめる	しめる	shimeru	to close
しる	しる	shiru	to know
すう	すう	suu	to breath, to smoke
すむ	すむ	sumu	to live, to reside somewhere
する	する	suru	to do
すわる	すわる	suwaru	to sit
だす	だす	dasu	to take out, hand in
たつ	たつ	tatsu	to stand
たのむ	たのむ	tanomu	to ask, to request
たべる	たべる	taberu	to eat
ちがう	ちがう	chigau	different
つかう	つかう	tsukau	to use
つかれる	つかれる	tsukareru	to get tired
つく	つく	tsuku	to arrive
つくる	つくる	tsukuru	to make, to produce
つける	つける	tsukeru	to turn on
つとめる	つとめる	tsutomeru	to work for someone
でかける	でかける	dekakeru	to go out
できる	できる	dekiru	can
でる	でる	deru	to leave
とぶ	とぶ	tobu	to fly
とまる	とまる	tomaru	to stop
とる	とる	toru	to take
なく	なく	naku	to sing, mew, moo
ならぶ	ならぶ	narabu	to form a line
ならべる	ならべる	naraberu	to line up
なる	なる	naru	to become
ぬぐ	ぬぐ	nugu	to take off clothes
ねる	ねる	neru	to sleep
のぼる	のぼる	noboru	to climb up
のむ	のむ	nomu	to drink
のる	のる	noru	to take, to ride
はいる	はいる	hairu	to enter
はく	はく	haku	to put on shoes
はじまる	はじまる	hajimaru	to begin, to start
はしる	はしる	hashiru	to run
はたらく	はたらく	hataraku	to work
はなす	はなす	hanasu	to talk, to speak, to tell
はる	はる	haru	to put something on, to stick
はれる	はれる	hareru	to clear up
ひく	ひく	hiku	to pull
ふく	ふく	fuku	clothes
ふる	ふる	furu	to fall (rain, snow
まがる	まがる	magaru	to turn
まつ	まつ	matsu	to wait
みがく	みがく	migaku	to polish, to brush
みせる	みせる	miseru	to show
みる	みる	miru	to see, to watch
もつ	もつ	motsu	to have, to own
やすむ	やすむ	yasumu	to rest
やる	やる	yaru	to do
よぶ	よぶ	yobu	to call
よむ	よむ	yomu	to read
わかる	わかる	wakaru	to know, to understand
わすれる	わすれる	wasureru	to forget
わたす	わたす	watasu	to hand over
わたる	わたる	wataru	to cross
アベック	アベック	abekku	romantic couple
アイドル	アイドル	aidoru	(teen) idol
アイス	アイス	aisu	ice
アイスクリーム	アイスクリーム	aisukuriimu	ice cream
アイゼン	アイゼン	aizen	crampons
アメフト	アメフト	amefuto	American football
アメリカンドッグ	アメリカンドッグ	amerikandoggu	corn dog
アニメ	アニメ	anime	animation
アニソン	アニソン	anison	an anime song
アンケート	アンケート	ankeeto	questionnaire
アンニュイ	アンニュイ	annyui	ennui
アンサー	アンサー	ansaa	reply to a question
アパート	アパート	apaato	apartment
アポ	アポ	apo	appointment
アロエ	アロエ	aroe	aloe
アルバイト	アルバイト	arubaito	part-time job
アールブイ	アールブイ	aarubui	truck
アルコール	アルコール	arukooru	álcool
アウトコース	アウトコース	autokoosu	outside
バーゲン	バーゲン	baagen	a sale at a store
バイキング	バイキング	baikingu	smorgasbord
バイク	バイク	baiku	a motorcycle
バカンス	バカンス	bakansu	holiday
ブックカバー	ブックカバー	bukkukabaa	dust jacket
バックミラー	バックミラー	bakkumiraa	rear-view mirror
バックナンバー	バックナンバー	bakkunanbaa	back issue
バックネット	バックネット	bakkunetto	a backstop (in baseball)
バリアフリー	バリアフリー	bariafurii	Accessible facilities for handicapped persons
バリカン	バリカン	barikan	Hand or electric operating hair trimmer
バター	バター	bataa	butter
バッティング	バッティング	battingu	Swing the bat in baseball
ベビーカー	ベビーカー	bebiikaa	stroller (US)
ベッドタウン	ベッドタウン	beddotaun	bedroom suburbs
ビジネスホテル	ビジネスホテル	bijinesuhoteru	budget hotel
ビロード	ビロード	biroodo	velvet
ビル	ビル	biru	building (especially modern steel / concrete buildings)
ビール	ビール	biiru	beer
ボンベ	ボンベ	bonbe	a steel canister for storing pressurized gas
ボタン	ボタン	botan	button
ブランコ	ブランコ	buranko	a swing
ブレザー	ブレザー	burezaa	blazer
ブルマ	ブルマ	buruma	short pants worn for exercise by girls
チアリーダー	チアリーダー	chiariidaa	cheerleader
チアリーディング	チアリーディング	chiariidingu	cheerleading
チケット	チケット	chiketto	ticket
チンキ	チンキ	chinki	tincture
チューハイ or 酎ハイ	チューハイ or 酎ハイ	chuuhai	a kind of alcoholic drink originating from Japan
コラボ	コラボ	korabo	A term for when two separate entities come together and make something
デパート	デパート	depaato	department store
デッサン	デッサン	dessan	drawing
デスク	デスク	desuku	an editor for a certain section of a publication
ドイツ	ドイツ	doitsu	Deutsch(land)
ドンマイ	ドンマイ	donmai	'dont worry about it'
ドライバー	ドライバー	doraibaa	a screwdriver
ドライブイン	ドライブイン	doraibuin	rest area
ドラマ	ドラマ	dorama	TV drama
ドリフト	ドリフト	dorifuto	drifting
エアコン	エアコン	eakon	air conditioning or air conditioner
エキス	エキス	ekisu	extract
エネルギッシュ	エネルギッシュ	enerugisshu	energetic
エンスト	エンスト	ensuto	stall (as in an automobile engine)
エレベーター	エレベーター	erebeetaa	elevator (American English)
エール	エール	eeru	(1) to cheer on a player in a sports competition; (2) to express support for a candidate in an election
エスカレーター	エスカレーター	esukareetaa	escalator
エステ	エステ	esute	beauty salon
エッチ	エッチ	etchi	dirty
ファイナル	ファイナル	fainaru	last
ファミコン	ファミコン	famikon	fami(ly) com(puter)
ファンファーレ	ファンファーレ	fanfaare	a musical fanfare
ファンタジック	ファンタジック	fantajikku	fantastic
フェッチ	フェッチ	fetchi	(Computer Jargon) To fetch an instruction from main memory when a microprocessor executes a command
フォアボール	フォアボール	foabooru	walk
フライ	フライ	furai	Deep frying
フリーター	フリーター	furiitaa	underemployed young adults
フロント	フロント	furonto	the reception desk
ガラス or 硝子	ガラス or 硝子	garasu	glass (material)
ガーゼ	ガーゼ	gaaze	gauze
ゲレンデ	ゲレンデ	gerende	ski slope
ゴム	ゴム	gomu	rubber
ググる	ググる	guguru	to google
グラス	グラス	gurasu	drinking glass
グロ	グロ	guro	grotesque
ギャラリー	ギャラリー	gyararii	an art gallery
ハイカラ	ハイカラ	haikara	In 1920s slang
ハイネック	ハイネック	hainekku	A turtleneck style shirt or sweater
ハイタッチ	ハイタッチ	haitatchi	High five
ハッカー	ハッカー	hakkaa	refers specifically to a computer black hat
ハモる	ハモる	hamoru	to harmonize (when singing)
ハンバーグ	ハンバーグ	hanbaagu	Salisbury steak
ハンドル	ハンドル	handoru	steering wheel or bicycle handlebars
ハンカチ	ハンカチ	hankachi	handkerchief
ハンスト	ハンスト	hansuto	hunger strike
ハウス	ハウス	hausu	greenhouse or glasshouse
ヒステリー	ヒステリー	hisuterii	loss of (self) control
ヒップ	ヒップ	hippu	buttocks
ホルモン	ホルモン	horumon	hormone; also offal when served for yakiniku or hotpot
ホース	ホース	hoosu	a hose
ホッチキス	ホッチキス	hotchikisu	stapler (a genericized trademark of the E. H. Hotchkiss company
ホーム	ホーム	hoomu	a railway platform
イエス	イエス	iesu	Jesus
イギリス	イギリス	igirisu	English
イクラ	イクラ	ikura	salmon roe
イメージ	イメージ	imeeji	an image
インフレ	インフレ	infure	inflation
イラスト	イラスト	irasuto	an illustration
ジャンパー	ジャンパー	janpaa	jacket
ジンギスカン	ジンギスカン	jingisukan	Jingisukan (Mongolian style barbecue with cut lamb and vegetables)
ジーパン	ジーパン	jiipan	jeans
ジュース	ジュース	juusu	often used to refer to soda or energy drinks
カメラマン	カメラマン	kameraman	photographer
カン	カン	kan	can (beverage can or tin can)
カンニング	カンニング	kanningu	cheating
カッパ	カッパ	kappa	(rain) coat
カラン	カラン	karan	faucet
カラオケ	カラオケ	karaoke	empty) + orche(stra)
カルキ	カルキ	karuki	lime (mineral)
カルピス	カルピス	karupisu	Calpis (a milky soft drink)
カルタ	カルタ	karuta	karuta (Japanese playing cards)
カルテ	カルテ	karute	(a patients) medical record
コーヒー	コーヒー	koohii	coffee
コック	コック	kokku	a cook
コミカライズ	コミカライズ	komikaraizu	to make a comic strip (manga) version of an originally non-comic strip title
コンビニ	コンビニ	konbini	convenience store
コンビナート	コンビナート	konbinaato	Combine (enterprise)
コンクール	コンクール	konkuuru	a contest
コンセント	コンセント	konsento	power outlet
コント	コント	konto	a short comedy
コップ	コップ	koppu	cup, glass
コラーゲン	コラーゲン	koraagen	collagen
コロッケー	コロッケー	korokkee	croquette
コスプレ	コスプレ	kosupure	cosplay (a subculture involving dressing up in costumes
クラブ	クラブ	kurabu	a club or society
クラクション	クラクション	kurakushon	horn (on an automobile)
クランケ	クランケ	kuranke	patient
クレーム	クレーム	kureemu	a complaint
クリスタル	クリスタル	kurisutaru	shiny or clear
キーボード	キーボード	kiiboodo	a keyboard
キャベツ	キャベツ	kyabetsu	cabbage
キャンペーン	キャンペーン	kyanpeen	a sales campaign or sweepstakes
キャップ	キャップ	kyappu	cap
ママ	ママ	mama	mom
マンダラ	マンダラ	mandara	circle
マニア	マニア	mania	enthusiasm
マンション	マンション	manshon	modern concrete apartment / condominium block
マロン	マロン	maron	chestnut
マスコミ	マスコミ	masukomi	mass media
メーカー	メーカー	meekaa	manufacturer
メール	メール	meeru	e-mail
ミイラ	ミイラ	miira	a mummy
ミルク	ミルク	miruku	milk
ミシン	ミシン	mishin	sewing machine
モバイル	モバイル	mobairu	mobile communications
ムーディ	ムーディ	muudi	nice
ナイター	ナイター	naitaa	a night game
ニート　or NEET	ニート　or NEET	niito	Education or Training
ノルマ	ノルマ	noruma	quota
ノート	ノート	nooto	notebook
オーディエンス	オーディエンス	oodiensu	group of people who participate in a show
オフ	オフ	ofu	a sale at a store; e.g.
オペ	オペ	ope	surgical operation
オーライ	オーライ	oorai	all right
オルゴール	オルゴール	orugooru	a music box or any instrument that operates off of a music roll such as a calliope
オートバイ	オートバイ	ootobai	motorcycle
パイン	パイン	pain	pineapple
パーマ	パーマ	paama	perm
パン	パン	pan	bread
パネリスト	パネリスト	panerisuto	panelist
パンク	パンク	panku	flat tire
パンスト	パンスト	pansuto	pantyhose
パソコン	パソコン	pasokon	PC
パンツ	パンツ	pantsu	underpants (American English)
パパ	パパ	papa	dad
ペチカ	ペチカ	pechika	Russian oven
ペンション	ペンション	penshon	a resort hotel / chalet / cottage
ピエロ	ピエロ	piero	a clown
ピーマン	ピーマン	piiman	sweet bell pepper
ピッケル	ピッケル	pikkeru	ice axe
ピンチ	ピンチ	pinchi	potentially disastrous situation
ピンセット	ピンセット	pinsetto	tweezers
ポエマー	ポエマー	poemaa	a poet
ポケベル	ポケベル	pokeberu	beeper
ポケモン	ポケモン	pokemon	Pokémon
ポンプ	ポンプ	ponpu	pump
ポシェット	ポシェット	poshetto	a small bag
ポスト	ポスト	posuto	a mailbox (US)
プロフィール	プロフィール	purofiiru	a profile
プロレス	プロレス	puroresu	professional wrestling
ライバル	ライバル	raibaru	A fellow competitor or an enemy
ライフライン	ライフライン	raifurain	infrastructure
ラッコ	ラッコ	rakko	a sea otter
ランドセル	ランドセル	randoseru	a hard schoolbag
レジュメ	レジュメ	rejume	a resume
レントゲン	レントゲン	rentogen	X-ray
レストラン	レストラン	resutoran	restaurant
リベンジ	リベンジ	ribenji	return match
リフォーム	リフォーム	rifoomu	remodel
リモコン	リモコン	rimokon	remote control
リニューアル	リニューアル	rinyuuaru	remodeling
リストラ	リストラ	risutora	(noun) restructuring
ロマン	ロマン	roman	novel
ロープウェー	ロープウェー	roopuwee	ropeway
ルー	ルー	ruu	roux
ルポ	ルポ	rupo	Reportage
リュックサック	リュックサック	ryukkusakku	backpack
サービス	サービス	saabisu	service
サボる	サボる	saboru	to slack off
サイダー	サイダー	saidaa	a kind of soda unrelated to actual cider
サイン	サイン	sain	signature
サインペン	サインペン	sainpen	marker
サンドイッチ or サンド	サンドイッチ or サンド	sandoitchi	sand(wich)
サンドバッグ	サンドバッグ	sandobaggu	punching bag
サラダ	サラダ	sarada	salad
サラリーマン	サラリーマン	sarariiman	salaryman: a salaried office/white collar worker
センス	センス	sensu	understanding of subtleties
セツナ	セツナ	setsuna	moment
シーエム	シーエム	shiiemu	television commercial
シール	シール	shiiru	sticker
シュークリーム	シュークリーム	shuukuriimu	a cream puff
ソフト	ソフト	sofuto	video game console or computer software; also used to describe tasks or work (such as design) requiring imagination
スカイ	スカイ	sukai	a bib
スケボー	スケボー	sukeboo	skateboard
スケルトン	スケルトン	sukeruton	translucent
スキー	スキー	sukii	used as a noun to refer to skiing
スコップ	スコップ	sukoppu	trowel
スマート	スマート	sumaato	slim
スマホ	スマホ	sumaho	smartphone
スムーズ	スムーズ	sumuuzu	When a plan or transaction happens without incident
スーパー	スーパー	suupaa	supermarket
スピン	スピン	supin	a ribbon or tassel on a book
スポイト	スポイト	supoito	syringe
ストーブ	ストーブ	sutoobu	stove, heater
タイムリー	タイムリー	taimurii	a clutch hit (in baseball)
タレント	タレント	tarento	TV personality/celebrity
テーマ	テーマ	teema	theme
テンキー	テンキー	tenkii	numeric keypad
テンション	テンション	tenshon	a state of excitement
テレビ	テレビ	terebi	TV
テレフォン	テレフォン	terefon	a system that converts acoustic vibrations to electrical signals in order to transmit sound
テレカ	テレカ	tereka	prepaid card for using public telephones
ティーンエージャー	ティーンエージャー	tiineejaa	A person in their teens
トーチカ	トーチカ	toochika	bunker
トイレ	トイレ	toire	toilet, lavatory
トランプ	トランプ	toranpu	playing cards
トレーナー	トレーナー	toreenaa	a sweat shirt
ワープロ	ワープロ	waapuro	word processor
ヨット	ヨット	yotto	a sailboat or yacht
ゼン	ゼン	zen	a meditation
ゼロ	ゼロ	zero	zero
トマト	トマト	tomato	tomato
アフターサービス	アフターサービス	afutaasaabisu	customer service
ボールペン	ボールペン	boorupen	ballpen
キャビンアテンダント	キャビンアテンダント	kyabinatendanto	A flight attendant
コンピューター	コンピューター	konpyuutaa	computer
ダブル(noun)	ダブル(noun)	daburu	double
ダンプカー	ダンプカー	danpukaa	dump truck (US)
ダストボックス	ダストボックス	dasutobokkusu	rubbish bin (UK)
デッドボール	デッドボール	deddobooru	hit by a pitch
デコレーションケーキ	デコレーションケーキ	dekoreeshonkeeki	a fancy cake
ドクター ストップ	ドクター ストップ	dokutaasutoppu	when the doctor tells a patient to stop doing something
フライドポテト	フライドポテト	furaidopoteto	french fries (US)
フリーダイアル	フリーダイアル	furiidaiaru	toll free call
フリーサイズ	フリーサイズ	furiisaizu	one-size-fits-all
フロントガラス	フロントガラス	furontogarasu	windshield (US)
ガードマン	ガードマン	gaadoman	a (private) security guard
ガソリンスタンド	ガソリンスタンド	gasorinsutando	gas station (US)
ガッツポーズ	ガッツポーズ	gattsupoozu	fist pump
ゲームセンター	ゲームセンター	geemusentaa	video arcade
ゴールデンアワー	ゴールデンアワー	goorudenawaa	prime time in Japanese television
ゴールデンウィーク	ゴールデンウィーク	goorudenwiiku	A week of holidays in Japan
ハッピーエンド	ハッピーエンド	happiiendo	a happy ending
ハンドルキーパー	ハンドルキーパー	handorukiipaa	designated driver
ハンドルネーム	ハンドルネーム	handoruneemu	handle
ヘアピンカーブ	ヘアピンカーブ	heapinkaabu	hairpin turn
ヘルスメーター	ヘルスメーター	herusumeetaa	bathroom scales
ホットケーキ	ホットケーキ	hottokeeki	a pancake
ホワイトデー	ホワイトデー	howaitodee	White Day
イン・キー	イン・キー	inkii	locking ones car keys inside of ones car
ジェンダーフリー	ジェンダーフリー	jendaafurii	gender equality
ジェットコースター	ジェットコースター	jettokoosutaa	roller coaster
カモン	カモン	kamon	An invitation to join an activity
カリウム	カリウム	kariumu	potassium
カシューナッツ	カシューナッツ	kashuunattsu	cashew
カステラ	カステラ	kasutera	a kind of sponge cake popular at festivals and as a street food in Japan
キーホルダー	キーホルダー	kiihorudaa	key ring
キスマーク	キスマーク	kisumaaku	hickey
キッチンペーパー	キッチンペーパー	kitchinpeepaa	paper towel
コインランドリー	コインランドリー	koinrandorii	laundromat (US)
コインロッカー	コインロッカー	koinrokkaa	type of locker
キャンピングカー	キャンピングカー	kyanpingukaa	a recreational vehicle
キャッチボール	キャッチボール	kyatchibooru	the game of catch
キャッチホン	キャッチホン	kyatchihon	call waiting
キャッチコピー	キャッチコピー	kyatchikopii	tagline
マグカップ	マグカップ	magukappu	mug
マイナスドライバー	マイナスドライバー	mainasudoraibaa	(flathead) screwdriver
マジックテープ	マジックテープ	majikkuteepu	Velcro
メールマガジン	メールマガジン	meerumagajin	e-mail newsletter
モーニングコール	モーニングコール	mooningukooru	wake-up call
モーニングコート	モーニングコート	mooningukooto	morning coat
モーニングサービス	モーニングサービス	mooningusaabisu	breakfast special
ナンバーディスプレイ	ナンバーディスプレイ	nanbaadisupurei	caller ID
ナンバープレート	ナンバープレート	nanbaapureeto	number plate
ノークレームノーリターン	ノークレームノーリターン	nookureemunooritaan	no return
オープンカー	オープンカー	oopunkaa	convertible (automobile)
パーソナルコンピューター	パーソナルコンピューター	paasonarukonpyuutaa	personal computer
ペアルック	ペアルック	pearukku	matching outfits (usually between a couple)
ペーパーカンパニー	ペーパーカンパニー	peepaakanpanii	dummy company
ペーパードライバー	ペーパードライバー	peepaadoraibaa	a person who has a drivers license but does not usually drive (i.e.: a driver only on paper)
ペーパーテスト	ペーパーテスト	peepaatesuto	written examination/test
プラスアルファ	プラスアルファ	purasuarufa	in addition
プラスドライバー	プラスドライバー	purasudoraibaa	Phillips screwdriver
プレイガイド	プレイガイド	pureigaido	(theater) ticket agency
プッシュホン	プッシュホン	pusshuhon	touch-tone phone
ライブアクション	ライブアクション	raibuakushon	animated
ライブハウス	ライブハウス	raibuhausu	club with live music
ランニングホームラン	ランニングホームラン	ranninguhoomuran	an inside-the-park home run
ランニングシャツ	ランニングシャツ	ranningushatsu	a sleeveless T-shirt
リードオンリーメンバー	リードオンリーメンバー	riidoonriimenbaa	an internet lurker
リンクフリー	リンクフリー	rinkufurii	free to link
リサイクルショップ	リサイクルショップ	risaikurushoppu	secondhand shop (selling used
ロードショー	ロードショー	roodoshoo	premiere
ロマンスグレー	ロマンスグレー	romansuguree	silver-gray hair
ロマンスカー	ロマンスカー	romansukaa	deluxe train
ロスタイム	ロスタイム	rosutaimu	added time
サイドブレーキ	サイドブレーキ	saidobureeki	hand brake
シルバーシート	シルバーシート	shirubaashiito	priority seating on public transportation
ソフトクリーム	ソフトクリーム	sofutokuriimu	soft serve (ice cream)
ソーラーシステム	ソーラーシステム	sooraashisutemu	a solar battery
スイートルーム	スイートルーム	suiitoruumu	a suite in a hotel
スリーサイズ	スリーサイズ	suriisaizu	three primary female body measurements (bust
ストライキ	ストライキ	sutoraiki	labor strike
ストレートティー	ストレートティー	sutoreetotii	black tea without milk
スーツアクター	スーツアクター	suutsuakutaa	suit actor
タバコ	タバコ	tabako	tabaco
タイムオーバー	タイムオーバー	taimuoobaa	when a time limit has been reached
タオルケット	タオルケット	taoruketto	a type of blanket made of a material similar to a beach
テレビゲーム	テレビゲーム	terebigeemu	video game
トレーニングパンツ	トレーニングパンツ	toreeningupantsu	pants for toddlers
ウィンカー	ウィンカー	winkaa	turn signal
ヴァージンロード	ヴァージンロード	vaajinroodo	the aisle (in a Western-style
ワイドショー	ワイドショー	waidoshoo	talk show
ワイシャツ	ワイシャツ	waishatsu	white shirt
ワンパターン	ワンパターン	wanpataan	of (artificial
ワンピース	ワンピース	wanpiisu	(a single-piece) dress
ヤンエグ	ヤンエグ	yanegu	young executive
ヨードチンキ	ヨードチンキ	yoodochinki	tincture of iodine
ユニットバス	ユニットバス	yunittobasu	modular bath
Uターンラッシュ	Uターンラッシュ	yuutaanrasshu	the rush of traffic and people
ゼミナール	ゼミナール	zeminaaru	seminar
あおい	あおい	aoi	blue
あかい	あかい	akai	red
あかるい	あかるい	akarui	light, bright
あき	あき	aki	autumn, fall
あさ	あさ	asa	morning
あさごはん	あさごはん	asagohan	breakfast
あした	あした	ashita	tomorrow
あそこ	あそこ	asoko	over there
あたたかい	あたたかい	atatakai	warm
あたま	あたま	atama	head
あたらしい	あたらしい	atarashii	new
あつい	あつい	atsui	thick
あに	あに	ani	older brother
あね	あね	ane	older sister
あの	あの	ano	well, then
あぶない	あぶない	abunai	dangerous
あまい	あまい	amai	sweet
あまり	あまり	amari	not so
あめ	あめ	ame	rain
あれ	あれ	are	that one
いいえ	いいえ	iie	no
いえ	いえ	ie	house, home
いくら	いくら	ikura	how much
いけ	いけ	ike	pond
いしゃ	いしゃ	isha	doctor
いす	いす	isu	chair
いち	いち	ichi	one
いつ	いつ	itsu	when
いつつ	いつつ	itsutsu	five
いつも	いつも	itsumo	always
いま	いま	ima	now
いみ	いみ	imi	meaning
いろ	いろ	iro	color
いろいろ	いろいろ	iroiro	various
うすい	うすい	usui	thin
うた	うた	uta	song
うち	うち	uchi	home
うみ	うみ	umi	sea
うわぎ	うわぎ	uwagi	coat, jacket
え	え	e	picture
えいが	えいが	eiga	movie
えいがかん	えいがかん	eigakan	cinema
えいご	えいご	eigo	English language
えき	えき	eki	station
エレベータ	エレベータ	erebeeta	elevator
えん	えん	en	Yen
おいしい	おいしい	oishii	tasty, delicious
おおぜい	おおぜい	oozei	many people
おかし	おかし	okashi	confectionary, cake
おくさん	おくさん	okusan	someone’s wife
おさけ	おさけ	osake	alcohol, sake
おさら	おさら	osara	plate
おじいさん	おじいさん	ojiisan	grand father
おそい	おそい	osoi	late, slow
おちゃ	おちゃ	ocha	tea
おてあらい	おてあらい	otearai	toilet, lavatory
おとうさん	おとうさん	otousan	father
おとこ	おとこ	otoko	man
おとこのこ	おとこのこ	otokonoko	boy
おとな	おとな	otona	adult
おなじ	おなじ	onaji	same
おばさん	おばさん	obasan	aunt
おばあさん	おばあさん	obaasan	grandmother
おべんとう	おべんとう	obentou	lunchbox
おもい	おもい	omoi	heavy
おもしろい	おもしろい	omoshiroi	interesting, funny
おんがく	おんがく	ongaku	music
おんな	おんな	onna	woman
おんなのこ	おんなのこ	onnanoko	girl
がいこく	がいこく	gaikoku	foreign country
がいこくじん	がいこくじん	gaikokujin	foreigner
かいしゃ	かいしゃ	kaisha	company, enterprise
かいだん	かいだん	kaidan	stairs
かお	かお	kao	face
かぎ	かぎ	kagi	key
がくせい	がくせい	gakusei	student
かさ	かさ	kasa	umbrella
かぜ	かぜ	kaze	a cold
かぞく	かぞく	kazoku	family
かた	かた	kata	person (polite)
かたかな	かたかな	katakana	Katakana
いちがつ	いちがつ	ichigatsu	January
にがつ	にがつ	nigatsu	February
さんがつ	さんがつ	sangatsu	March
しがつ	しがつ	shigatsu	April
ごがつ	ごがつ	gogatsu	May
ろくがつ	ろくがつ	rokugatsu	June
しちがつ	しちがつ	shichigatsu	July
はちがつ	はちがつ	hachigatsu	August
くがつ	くがつ	kugatsu	September
じゅうがつ	じゅうがつ	juugatsu	October
じゅういちがつ	じゅういちがつ	juuichigatsu	November
じゅうにがつ	じゅうにがつ	juunigatsu	December
がっこう	がっこう	gakkou	school
かど	かど	kado	corner
かない	かない	kanai	my wife
かばん	かばん	kaban	bag
かびん	かびん	kabin	vase
かみ	かみ	kami	paper
かめら	かめら	kamera	camera
かようび	かようび	kayoubi	Tuesday
からい	からい	karai	hot, spicy
からだ	からだ	karada	body
かるい	かるい	karui	light (not heavy)
カレンダー	カレンダー	karendaa	calendar
かわ	かわ	kawa	river
き	き	ki	tree
きいろい	きいろい	kiiroi	yellow
きた	きた	kita	north
ギター	ギター	gitaa	guitar
きたない	きたない	kitanai	dirty
きっさてん	きっさてん	kissaten	coffee shop
きって	きって	kitte	stamp
きっぷ	きっぷ	kippu	ticket
きのう	きのう	kinou	yesterday
きゅう	きゅう	kyuu	nine
ぎゅうにく	ぎゅうにく	gyuuniku	beef
ぎゅうにゅう	ぎゅうにゅう	gyuunyuu	milk
きょう	きょう	kyou	today
きょうしつ	きょうしつ	kyoushitsu	class room
きょうだい	きょうだい	kyoudai	siblings
きょねん	きょねん	kyonen	last year
きれい	きれい	kirei	beautiful, clean
キロ	キロ	kiro	km
ぎんこう	ぎんこう	ginkou	bank
きんようび	きんようび	kinyoubi	Friday
く	く	ku	nine
くすり	くすり	kusuri	medicine
ください	ください	kudasai	give me…
くだもの	くだもの	kudamono	fruit
くち	くち	kuchi	mouth
くつ	くつ	kutsu	shoe
くつした	くつした	kutsushita	socks
くに	くに	kuni	country
くもり	くもり	kumori	cloudy weather
くらい	くらい	kurai	dark
ぐらい	ぐらい	gurai	about
クラス	クラス	kurasu	class
グラム	グラム	guramu	gram
くるま	くるま	kuruma	car
くろい	くろい	kuroi	black
けさ	けさ	kesa	this morning
けっこん	けっこん	kekkon	marriage
げつようび	げつようび	getsuyoubi	Monday
ご	ご	go	five
こうばん	こうばん	kouban	police box
こえ	こえ	koe	voice
コート	コート	kooto	coat
ここ	ここ	koko	here
ごご	ごご	gogo	afternoon
ここのつ	ここのつ	kokonotsu	nine
ごぜん	ごぜん	gozen	morning, a.m.
ことし	ことし	kotoshi	this year
ことば	ことば	kotoba	phrase, language
こども	こども	kodomo	child
この	この	kono	this…
これ	これ	kore	this
ごろ	ごろ	goro	around…
こんげつ	こんげつ	kongetsu	this month
こんしゅう	こんしゅう	konshuu	this week
こんばん	こんばん	konban	this evening
さあ	さあ	saa	well…
さかな	さかな	sakana	fish
さき	さき	saki	earlier, former
さくぶん	さくぶん	sakubun	composition
ざっし	ざっし	zasshi	magazine
さとう	さとう	satou	sugar
さむい	さむい	samui	cold
さん	さん	san	three
し	し	shi	four
しお	しお	shio	salt
しかし	しかし	shikashi	however, but
じかん	じかん	jikan	time
しごと	しごと	shigoto	work
じしょ	じしょ	jisho	dictionary
しずか	しずか	shizuka	quiet
した	した	shita	under, below
しつもん	しつもん	shitsumon	question
じてんしゃ	じてんしゃ	jitensha	bicycle
じどうしゃ	じどうしゃ	jidousha	car, vehicle
じびき	じびき	jibiki	dictionary
じぶん	じぶん	jibun	oneself
じゃ	じゃ	ja	well, then
しゃしん	しゃしん	shashin	photo
シャツ	シャツ	shatsu	shirt
じゅう	じゅう	juu	ten
じゅぎょう	じゅぎょう	jugyou	lesson, class
しゅくだい	しゅくだい	shukudai	homework
しょうゆ	しょうゆ	shouyu	soy sauce
しろい	しろい	shiroi	white
しんぶん	しんぶん	shinbun	newspaper
すいようび	すいようび	suiyoubi	Wednesday
スカート	スカート	sukaato	skirt
すき	すき	suki	to like
すこし	すこし	sukoshi	a little
すずしい	すずしい	suzushii	cool
スプーン	スプーン	supuun	spoon
スポーツ	スポーツ	supootsu	sports
ズボン	ズボン	zubon	trousers
スリッパ	スリッパ	surippa	slipper
せい	せい	sei	height
せいと	せいと	seito	student
セーター	セーター	seetaa	sweater
せっけん	せっけん	sekken	soap
せびろ	せびろ	sebiro	jacket, suit
せまい	せまい	semai	narrow
せん	せん	sen	1,000, thousand
せんげつ	せんげつ	sengetsu	last month
せんしゅう	せんしゅう	senshuu	last week
せんせい	せんせい	sensei	teacher
ぜんぶ	ぜんぶ	zenbu	all
そう	そう	sou	so
そうじ	そうじ	souji	to clean
そうして	そうして	soushite	and then
そこ	そこ	soko	there
そちら	そちら	sochira	there (polite)
そと	そと	soto	outside
その	その	sono	that…
そば	そば	soba	next to
そら	そら	sora	sky
それ	それ	sore	that
それから	それから	sorekara	after that
それでは	それでは	soredewa	then, well
だいがく	だいがく	daigaku	university
たいしかん	たいしかん	taishikan	embassy
だいじょうぶ	だいじょうぶ	daijoubu	OK
たいせつ	たいせつ	taisetsu	very important
たいてい	たいてい	taitei	mostly, usually
だいどころ	だいどころ	daidokoro	kitchen
たいへん	たいへん	taihen	very, serious
たかい	たかい	takai	high, expensive
たくさん	たくさん	takusan	many, much
タクシー	タクシー	takushii	taxi
たてもの	たてもの	tatemono	building
たのしい	たのしい	tanoshii	pleasant, enjoyable
たばこ	たばこ	tabako	cigarette
たぶん	たぶん	tabun	perhaps, probably
たべもの	たべもの	tabemono	food
たまご	たまご	tamago	egg
だれ	だれ	dare	who?
たんじょうび	たんじょうび	tanjoubi	birthday
だんだん	だんだん	dandan	gradually
ちいさい	ちいさい	chiisai	small
ちかい	ちかい	chikai	near, close
ちかてつ	ちかてつ	chikatetsu	subway
ちず	ちず	chizu	map
ちち	ちち	chichi	my father
ちゃいろ	ちゃいろ	chairo	brown
ちゃわん	ちゃわん	chawan	rice bowl
ちょうど	ちょうど	choudo	just
ちょっと	ちょっと	chotto	a little
つぎ	つぎ	tsugi	next
つくえ	つくえ	tsukue	table
つまらない	つまらない	tsumaranai	uninteresting
つめたい	つめたい	tsumetai	cold
つよい	つよい	tsuyoi	strong
て	て	te	hand
テープ	テープ	teepu	tape
テーブル	テーブル	teeburu	table
てがみ	てがみ	tegami	letter
でぐち	でぐち	deguchi	exit
テスト	テスト	tesuto	test
では	では	dewa	then, well
でも	でも	demo	but
でます	でます	demasu	to leave
てんき	てんき	tenki	weather
でんき	でんき	denki	electricity
でんしゃ	でんしゃ	densha	train
でんわ	でんわ	denwa	phone
と	と	to	door
ドア	ドア	doa	door
どう	どう	dou	how?
どうして	どうして	doushite	why?
どうぶつ	どうぶつ	doubutsu	animal
どうも	どうも	doumo	thanks
とお	とお	too	ten
とおい	とおい	tooi	far
ときどき	ときどき	tokidoki	sometimes
とけい	とけい	tokei	watch, clock
どこ	どこ	doko	where?
ところ	ところ	tokoro	place
としょかん	としょかん	toshokan	library
どなた	どなた	donata	who (polite)
となり	となり	tonari	next to
どの	どの	dono	which?
ともだち	ともだち	tomodachi	friend
どようび	どようび	doyoubi	Saturday
とり	とり	tori	bird
とりにく	とりにく	toriniku	chicken meat
どれ	どれ	dore	which?
ナイフ	ナイフ	naifu	knife
なか	なか	naka	inside
ながい	ながい	nagai	long
なつ	なつ	natsu	summer
なつやすみ	なつやすみ	natsuyasumi	summer vacation
ななつ	ななつ	nanatsu	seven
なに	なに	nani	what?
なまえ	なまえ	namae	name
ならう	ならう	narau	to learn
に	に	ni	two
にぎやか	にぎやか	nigiyaka	lively
おにく	おにく	oniku	meat
にし	にし	nishi	west
にちようび	にちようび	nichiyoubi	Sunday
にもつ	にもつ	nimotsu	luggage
ニュース	ニュース	nyuusu	news
にわ	にわ	niwa	garden
ネクタイ	ネクタイ	nekutai	necktie
のみもの	のみもの	nomimono	drinks
は	は	ha	teeth
パーテイー	パーテイー	paateii	party
はい	はい	hai	yes
はいざら	はいざら	haizara	ashtray
はがき	はがき	hagaki	postcard
はこ	はこ	hako	box
はし	はし	hashi	chopsticks
バス	バス	basu	bus
はち	はち	hachi	eight
はな	はな	hana	nose
はなし	はなし	hanashi	conversation, tale
はは	はは	haha	my mother
はやい	はやい	hayai	fast, quick
ばん	ばん	ban	evening
ばんごう	ばんごう	bangou	number
ばんごはん	ばんごはん	bangohan	dinner
はんぶん	はんぶん	hanbun	half
ひがし	ひがし	higashi	east
ひくい	ひくい	hikui	low
ひこうき	ひこうき	hikouki	plane
ひだり	ひだり	hidari	left
ひと	ひと	hito	person
ひとつ	ひとつ	hitotsu	one
ひとつき	ひとつき	hitotsuki	one month
ひとり	ひとり	hitori	one person
ひゃく	ひゃく	hyaku	hundred
びょういん	びょういん	byouin	hospital
びょうき	びょうき	byouki	ill, sick
ひる	ひる	hiru	noon
ひるごはん	ひるごはん	hirugohan	lunch
ひろい	ひろい	hiroi	wide, spacious
フィルム	フィルム	firumu	film
ふうとう	ふうとう	fuutou	envelope
プール	プール	puuru	pool
フォーク	フォーク	fooku	fork
ふたつ	ふたつ	futatsu	two
ぶたにく	ぶたにく	butaniku	pork
ふたり	ふたり	futari	two people
ふとい	ふとい	futoi	thick, fat
ふるい	ふるい	furui	old
おふろ	おふろ	ofuro	bath
ページ	ページ	peeji	page
ベッド	ベッド	beddo	bed
へや	へや	heya	room
ぺん	ぺん	pen	pen
べんきょう	べんきょう	benkyou	to study
べんり	べんり	benri	convenient
ぼうし	ぼうし	boushi	hat
ほか	ほか	hoka	another, other
ポケット	ポケット	poketto	pocket
ほそい	ほそい	hosoi	thin, fine
ホテル	ホテル	hoteru	hotel
ほん	ほん	hon	book
ほんだな	ほんだな	hondana	bookshelf
ほんとうに	ほんとうに	hontouni	really
まいあさ	まいあさ	maiasa	every morning
まいしゅう	まいしゅう	maishuu	every week
まいにち	まいにち	mainichi	every day
まいばん	まいばん	maiban	every evening
まえ	まえ	mae	front
まずい	まずい	mazui	bad tasting
また	また	mata	also, again
まだ	まだ	mada	not yet
まち	まち	machi	city, town
マッチ	マッチ	matchi	matches
まど	まど	mado	window
まるい	まるい	marui	round
まん	まん	man	ten thousand
まんねんひつ	まんねんひつ	mannenhitsu	fountain pen
みぎ	みぎ	migi	right
みじかい	みじかい	mijikai	short
おみず	おみず	omizu	water
みせ	みせ	mise	shop
みち	みち	michi	road
みっつ	みっつ	mittsu	three
みなさん	みなさん	minasan	everyone
みなみ	みなみ	minami	south
みみ	みみ	mimi	ear
みんな	みんな	minna	all, everyone
むこう	むこう	mukou	over there
むずかしい	むずかしい	muzukashii	difficult
むっつ	むっつ	muttsu	six
め	め	me	eye
メートル	メートル	meetoru	meter
もう	もう	mou	one) more
もくようび	もくようび	mokuyoubi	Thursday
もちろん	もちろん	mochiron	of course
もっと	もっと	motto	more
もの	もの	mono	thing
もん	もん	mon	gate
もんだい	もんだい	mondai	problem, question
やおや	やおや	yaoya	vegetable shop
やさい	やさい	yasai	vegetable
やさしい	やさしい	yasashii	gentle
やすい	やすい	yasui	cheap, inexpensive
やすみ	やすみ	yasumi	holiday, vacation
やっつ	やっつ	yattsu	eight things
やま	やま	yama	mountain
よく	よく	yoku	often
よこ	よこ	yoko	horizontal
よっつ	よっつ	yottsu	four
よる	よる	yoru	night
らいげつ	らいげつ	raigetsu	next month
らいしゅう	らいしゅう	raishuu	next week
らいねん	らいねん	rainen	next year
ラジオ	ラジオ	rajio	radio
りっぱ	りっぱ	rippa	splendid
りゅうがくせい	りゅうがくせい	ryuugakusei	foreign student
りょうしん	りょうしん	ryoushin	parents
りょうり	りょうり	ryouri	cooking
りょこう	りょこう	ryokou	travel
れい	れい	rei	zero
れいぞうこ	れいぞうこ	reizouko	refrigerator
レコード	レコード	rekoodo	record
れんしゅう	れんしゅう	renshuu	practice
ろく	ろく	roku	six
わかい	わかい	wakai	young
わたし	わたし	watashi	me, I
わるい	わるい	warui	bad