今	いま	ima	now
今日	きょう	kyou	today
今年	ことし	kotoshi	this year
今週	こんしゅう	konshuu	this week
兄	あに	ani	olther brother
前	まえ	mae	in front (of); before (e.g. a building)
前半	ぜんはん	zenhan	first half
名前	なまえ	namae	name
荷物	にもつ	nimotsu	uggage; baggage
置く	おく	oku	to put
後	あと	ato	behind (time)
後ろ	うしろ	ushiro	back; behind
前後	ぜんご	zengo	front and rear
はれ後くもり	はれのちくもり	hare nochi kumori	first sunny later cloudy
また後で	またあとで	mata ato de	see you later
後半	こうはん	kouhan	second half
午前	ごぜん	gozen	morning; a.m.
午後	ごご	gogo	afternoon; p.m.
今週	こんしゅう	konshuu	this week​
週末	しゅうまつ	shuumatsu	weekend
週間	しゅうかん	shuukan	week
一週間	いっしゅうかん	isshoukan	one week
来週	らいしゅう	raishuu	next week
毎週	まいしゅう	maishuu	every week
毎	ごと	goto	each; every
毎日	まいにち	mainichi	every day
毎週	まいしゅう	maishuu	every week
毎月	まいつき	maitsuki	every month; each month
毎年	まいねん	mainen	every year; yearly; annually
朝	あさ	asa	morning
朝食	ちょうしょく	choushoku	breakfast
朝ご飯	あさごはん	asagohan	breakfast
朝日	あさひ	asabi	morning sun​
毎朝	まいあさ	maiasa	every morning
爽やか	さわやか	sawayaka	fresh; refreshing
今朝	けさ	kesa	this morning​
昼	ひる	hiru	noon; midday
昼食	ちゅうしょく	chuushoku	lunch; midday meal​
昼ご飯	ひるごはん	hirugohan	lunch; midday meal
昼休み	ひるやす	hiruyasumi	lunch break
今日	きょう	kyou	today; this day
夜	よる	yoru	night
夜中	よなか	yonaka	middle of the night
今夜	こんや	konya	this evening; tonight
外	そと	soto	outside; exterior
外	はこ	hako	another place; some other place
外す	はずす	hazusu	to remove; to take off; to detach; to unfasten; to undo
外国	がいこく	gaikoku	foreign country
外食	がいしょく	gaishoku	eating out; dining out​
内	うち	uchi	inside; within
国内	こくない	kokunai	internal; domestic
細い	ほそい	hosoi	thin; slender; fine​
重い	おもい	omoi	heavy; weighty​
春	はる	haru	spring; springtime
春分の日	しゅんぶんのひ	shunbunnohi	Vernal Equinox Day
青春	せいしゅん	seishuun	youth; springtime of life; adolescent
夏	なつ	natsu	summer
初夏	しょか	shoka	early summer
夏休み	なつやすみ	natsuyasumi	summer vacation; summer holiday
帰省	きせい	kisei	homecoming; returning home
秋	あき	aki	autumn; fall
季節	きせつ	kisetsu	season; time of year
秋分の日	しゅうぶんのひ	shuubunnohi	Autumnal Equinox Day
冬	ふゆ	fuyu	winter
春夏秋冬	しゅんかしゅうとう	shunkashuutou	the four seasons
多い	おおい	ooi	many; numerous; a lot
町	まち	machi	town
少ない	すくない	sukunai	few; a little; scarce; insufficient; seldom
少し	すこし	sukoshi	a little; a bit; a small amount;
少年	しょうねん	shounen	boy; juvenile; young boy
少女	しょうじょ	shoujo	girl (usu. between 7 and 17); young lady
小学生	しょうがくせい	shougakusei	elementary school student
通学	つうがく	tsuugaku	commuting to school
遠い	とおい	tooi	far; distant; far away; a long way off; in the distance
近い	ちかい	chikai	near; close; short (distance)
父	ちち	chichi	father
祖父	そふ	sofu	grandfather
お父さん	おとうさん	otousan	father; dad
母	はは	haha	mother
祖母	そぼ	sobo	grandmother
お母さん	おかあさん	okaasan	mother; mom
新聞	しんぶん	shinbun	newspaper
聞こえる	きこえる	kikoeru	to be heard; to be audible
聞く	きく	kiku	to hear
言語	げんご	gengo	language
言葉	ことば	kotoba	word; phrase; expression
伝言	でんごん	dengon	verbal message; word (from someone)
言う	いう	iu	to say
読む	よむ	yomu	to read
読書	どくしょ	dokusho	reading (a book)
句読点	くとうてん	kutouten	punctuation mark
兄	あに	ani	older brother; elder brother
兄弟	きょうだい	kyoudai	siblings; brothers and sisters; brothers
お兄さん	おにいさん	oniisan	older brother; elder brother
姉	あね	ane	older sister; elder sister
姉妹	しまい	shimai	sisters
お姉さん	おねえさん	oneesan	older sister; elder sister
弟	おとうと	otouto	younger brother; little brother; kid brother​
妹御	いもうと	imouto	younger sister
姉妹	しまい	shimai	sisters
頭	あたま	atama	head
頭痛	ずつう	sutsuu	headache
文頭	ぶんとう	buntou	start of a sentence
顔	かお	kao	face; visage
洗顔	せんがん	sengan	face-washing
古い	ふるい	furui	old; aged; ancient; antiquated; antique; timeworn​
中古	ちゅうこ	chuuko	used, second-hand
新しい	あたらしい	atarashii	new; novel; fresh; recent; latest; up-to-date; modern​
新た	あらた	arata	new; fresh; novel
新聞	しんぶん	shinbun	newspaper
新幹線	しんかんせん	shinkansen	Shinkansen; bullet train
新年	しんねん	shinnen	New Year
高い	たかい	takai	high; tall​
高校生	こうこうせい	koukousei	senior high school student
背が高い	せ が たかい	se ga takai	tall (of a person)
太い	ふとい	futoi	fat; thick
太る	ふとる	futoru	to put on weight; to gain weight
太鼓	たいこ	taiko	drum
丸太	まるた	maruta	log
細い	ほそい	hosoi	thin; slender; fine
細かい	こまかい	komakai	small
詳細	しょうさい	shousai	details; particulars; specifics​
注射器	ちゅうしゃき	chuushaki	syringe
明るい	あかるい	akarui	light; well-lit; well-lighted
明かり	あかり	akari	light; illumination; glow; gleam​
明ける	あける	akeru	to open (a door, etc.); to unwrap (e.g. parcel, package); to unlock
説明	せつめい	setsumei	explanation; exposition; description; account; caption; legend​
月明	げつめい	getsumei	moonlight
書く	かく	kaku	to write; to compose; to pen​
読書	どくしょ	doukusho	reading (a book)
書道	しょどう	shoudou	calligraphy
図書館	としょかん	toshoukan	library
辞書	じしょ	jisho	dictionary; lexicon
話	はなし	hanashi	talk; speech; chat; conversation
話す	はなす	hanasu	to talk; to speak; to converse; to chat​
会話	かいわ	kaiwa	conversation; talk; chat
電話	でんわ	denwa	telephone call; phone call
来る	くる	kuru	to come (spatially or temporally); to approach; to arrive​
来週	らいしゅう	raishuu	next week
来月	らいげつ	raigetsu	next month
来年	らいねん	rainen	next year​
来場	らいじょう	raijou	attendance
行う	おこなう	okonau	to perform; to do; to conduct oneself; to carry out
行く	いく	iku	to go; to move (towards); to head (towards); to leave (for)​
銀行	ぎんこう	ginkou	bank; banking institution
旅行	りょこう	ryokou	travel; trip; journey; excursion; tour
行列	ぎょうれつ	gyouretsu	line; queue
食べる	たべる	taberu	to eat
食う	くう	kuu	to eat​
食事	しょくじ	shokuji	meal; dinner
朝食	ちょうしょく	choushoku	breakfast
食堂	しょくどう	shokudou	dining room
思う	おもう	omou	to think; to consider; to believe; to reckon​
不思議	ふしぎ	fushigi	wonderful
思い出	おもいで	omoide	memories; recollections; reminiscence​